%%%%%%%%%%%%%%%%%%%
%  G o.     P  ..o%
%%%%%%%%%%%%%%%%%%%
%%%%%%%%%%%%%%%%%%%
